##############
#@           #
# $$$$  $$$$ #
# ....  .... #
#   ##  ##   #
#            #
##############
