###############
#@            #
# $$$  $$$ $$$#
# ...  ... ...#
#   ##   ##   #
#             #
###############
