#############
#@          #
# $$$  $$$$ #
# ...  .... #
#    ##     #
#           #
#############
